0000111111111111111111111111111111110000
0700110303030303030303030303030303010080
0000113111111111111031111111111111310000
0003030303030303011301130303030303030000
1110111111111111311031101111111111113111
1113130303030311011301131103030303010301
1030101111111011311031101131111111313131
1313131643030311011301131103030451010101
1010101111111111311031101111111111313131
1313131111111111011301131111111111010101
1010103030303030311031103030303030313131
1313111111111111011301131111111111110101
1010303030303011411031141130303030303131
1311111111111111111301111111111111111101
1011111111111111119039111111111111111131
1303030303030303030303030303030303030301
1030303030303030303030303030303030303031
1311111111111111119309111111111111111101
1011111111111111111031111111111111111131
1313030303030311411301141103030303030101
1010111111111111311031101111111111113131
1313130303030303011301130303030303010101
1010101111111111311031101111111111313131
1313131111111111011301131111111111010101
1010101840303011311031101130303471313131
1303131111111311011301131101111111010301
1110103030303011311031101130303030313111
1113111111111111011301131111111111110111
0000303030303030311031103030303030303000
0000110111111111111301111111111113110000
0500113030303030303030303030303030110060
0000111111111111111111111111111111110000
