1111111111111111111111111111111111111111
1000000000000000000000000000000000000001
1030202022022020202020202020202020202031
1001111001100111111111111110011001111021
1021111021102000000110000000211021111001
1001100001102020202110020202011000011021
1021102021111111100110211111111020211001
1001100111111111102110011111111110011021
1021102111100000000000200000011110211001
1001100001100202020202020202011000011021
1021102021102111111001111110011020211001
1001111001100100000000000010211001111021
1021111021102104005006007010011021111001
1000000001100111111111111110211000000001
1020202021102000000110000000011020202021
1001111000000202020110020202000001111021
1021111020002111102110211110002021111001
1000000001100111100110011110211000000021
1020202021102110000000000110011020202001
1001111001100110200202020110211001111001
1001111021102110011111100110011021111021
1021100001100110211111102110211000011001
1001102021100000000000000000011020211021
1021100111102020202020202020211110011001
1001102111111111100110211111111110211021
1021100001111111102110011111111000011001
1001102021100000000110200000011020211021
1021111001102020202110020202011001111001
1001111021100111111111111110211021111021
1020000000000000000000000000000000000001
1032020200202020000000002020202020202031
1111111111111111111111111111111111111111
