1111111111111111
1000000000000001
1110011110011001
1100011110001101
1100010110110101
1000011101110101
1000000100010101
1111111111110101
1000001000000101
1000000111111001
1000000000000001
1111111111111111
