0000111111111111111111111111111111110000
0000110303030303030303030303030303010000
0000113111111111111001111111111111310000
0000000303030303011001130303030303000000
1110000000000001311001101000000000000111
1110000000000001011001131000000000000301
1030000000000001311001101000000000003131
1313000000000001011001131000000000000101
1010000000000001311001101000000000003131
1313000000000000016005130000000000000101
1010000000000061310000101500000000003131
1313111111111011010000131101111111110101
1010303030303030910000193030303030303131
1311111111111111110000111111111111111101
1011111111111800000000000081111111111131
1300000000000000000aa0000000000000000001
1000000000000000000aa0000000000000000031
1311111111111700000000000071111111111101
1011111111111111110000111111111111111131
1313030303030303910000190303030303030101
1010111111111011310000101101111111113131
1313000000000081010000131700000000000101
1010000000000000310000100000000000003131
1313000000000001015006131000000000000101
1010000000000001311001101000000000003131
1303000000000001011301131000000000000301
1110000000000001311001101000000000000111
1110000000000001011001131000000000000111
0000003030303030311001103030303030000000
0000110111111111111001111111111113110000
0000113030303030303030303030303030110000
0000111111111111111111111111111111110000
