1111111111111111111001111111111111111111
1303030303030303030303030303030303030301
1011111011311111111111111111101131111131
1311111311030303030113030303031101111101
1011303011111111113110111111111130301131
1311011311111111110113111111111101131101
1011311011303030303110303030301131101131
1311011311011111111111111111131101131101
1011311011303030303030303030301131101131
1311030311011111111111111111131103031101
1011111011311111111111111111101131111131
1311111311030303030303030303031101111101
1030303011401111111221111111041130303031
1111111111111111111221111111111111111111
1111111111111822222222222251111111111111
3333333333331222222222222221333333333333
3333333333391222222222222221933333333333
1111111111111722222222222261111111111111
1111111111111111111221111111111111111111
1303030311401111111221111111041103030301
1011111011303030303030303030301131111131
1311111311011111111111111111131101111101
1011303011311111111111111111101130301131
1311011311030303030303030303031101131101
1011311011311111111111111111101131101131
1311011311030303030113030303031101131101
1011311011111111113110111111111131101131
1311030311111111110113111111111103031101
1011111011303030303110303030301131111131
1311111311011111111111111111131101111101
1030303030303030303030303030303030303031
1111111111111111111001111111111111111111
