1111111111111111111001111111111111111111
1000000000000000011001100000000000000001
1000000000000000011001100000000000000001
1000000000000000011001100000000000000001
1000000000000000011001100000000000000001
1000000000000000011001100000000000000001
1000000000000000011001100000000000000001
1000000000011111111001111101100000000001
1000000000011111111001100001100000000001
1000000000000000011001111101100000000001
1000000000010112111001111101100000000001
1000000000010112211001122201100000000001
1000000000010112611001152101100000000001
1111111111111111111001111111111111111111
1111111111111111111001111111111111111111
0000000000000000000000000000000000000000
0000000000000000000000000000000000000000
1111111111111111111001111111111111111111
1111111111111111111001111111111111111111
1000000000011012811001172110100000000001
1000000000011022211001122110100000000001
1000000000011011111001112110100000000001
1000000000011011111001100000000000000001
1000000000011000011001111111100000000001
1000000000011011111001111111100000000001
1000000000000000011001100000000000000001
1000000000000000011001100000000000000001
1000000000000000011001100000000000000001
1000000000000000011001100000000000000001
1000000000000000011001100000000000000001
1000000000000000011001100000000000000001
1111111111111111111001111111111111111111
