1111111111111111111111111111111111111111
1000000000000000000000000000000000000001
1011111101101111111111111111011011111101
1011111101100000000110000000011011111101
1000000001111111110110111111111000000001
1011111101111111110110111111111011111101
1011000001100000000110000000011000001101
1011011111101111111111111111011111101101
1011011111100000000000000000011111101101
1011000001101111111111111111011000001101
1011111101101000000000000001011011111101
1011111101101111111001111111011011111101
1000000001100000000000000000011000000001
1111111101101111111111111111011011111111
1111111101101222225118222221011011111111
0000000000002222222112222222000000000000
0000000000002222222112222222000000000000
1111111101101222226117222221011011111111
1111111101101111111111111111011011111111
1000000001100000000000000000011000000001
1011111101101111111001111111011011111101
1011111101101000000000000001011011111101
1011000001101111111111111111011000001101
1011011111100000000000000000011111101101
1011011111101111111111111111011111101101
1011000001100000000110000000011000001101
1011111101111111110110111111111011111101
1000000001111111110110111111111000000001
1011111101100000000110000000011011111101
1011111101101111111111111111011011111101
1000000000000000000000000000000000000001
1111111111111111111111111111111111111111
