1111111111111111111111111111111111111111
1303030303030303030303030303030303030301
1011111131101111111111111111311011111131
1311111101130303030113030303011311111101
1030303031111111113110111111111030303031
1311111101111111110113111111111311111101
1011303031103030303110303030311030301131
1311011111131111111111111111011111131101
1011311111103030303030303030311111101131
1311030301131111111111111111011303031101
1011111131101430303030303041311011111131
1311111101131111111301111111011311111101
1030303031103030303030303030311030303031
1111111101131111111111111111011311111111
1111111131101222225118222221311011111111
0000000000032222222112222222000300000000
0000000030002222222112222222300000000000
1111111101131222226117222221011311111111
1111111131101111111111111111311011111111
1303030301130303030303030303011303030301
1011111131101111111031111111311011111131
1311111101131904030303030341011311111101
1011303031101111111111111111311030301131
1311011111130303030303030303011111131101
1011311111101111111111111111311111101131
1311030301130303030113030303011303031101
1011111131111111113110111111111011111131
1303030301111111110113111111111303030301
1011111131103030303110303030311011111131
1311111101131111111111111111011311111101
1030303030303030303030303030303030303031
1111111111111111111111111111111111111111
