1111111111111111111001111111111111111111
1000000000000000000000000000000000000001
1011111011011111111111111111101101111101
1011111011000000000110000000001101111101
1011000011111111110110111111111100001101
1011011011111111110110111111111101101101
1011011011000000000110000000001101101101
1011011011011111111111111111101101101101
1011011011000000000000000000001101101101
1011000011011111111111111111101100001101
1011111011011111111111111111101101111101
1011111011000000000000000000001101111101
1000000011111111111221111111111100000001
1111111111111111111001111111111111111111
1111111111111800000000000051111111111111
0000000000001000000000000001000000000000
0000000000001000000000000001000000000000
1111111111111700000000000061111111111111
1111111111111111111001111111111111111111
1000000011111111111221111111111100000001
1011111011000000000000000000001101111101
1011111011011111111111111111101101111101
1011000011011111111111111111101100001101
1011011011000000000000000000001101101101
1011011011011111111111111111101101101101
1011011011000000000110000000001101101101
1011011011111111110110111111111101101101
1011000011111111110110111111111100001101
1011111011000000000110000000001101111101
1011111011011111111111111111101101111101
1000000000000000000000000000000000000001
1111111111111111111001111111111111111111
