0000111111111111111111111111111111110000
0000110303030303030303030303030303010000
0000113111111111111001111111111111310000
0000000303030303011001130303030303000000
1110000000000001311001101000000000000111
1110000000000001011001131000000000000301
1030000000000001311001101000000000000131
1313000000000001011001131000000000000101
1010000000000001311001101000000000000131
1313000000000000016005130000000000000101
1010000000000061310000101500000000000131
1313111111111011010000131101111111110101
1010303030303030910000193000000000000131
1311111111111111110000111111111111111101
1011111111111800000000000081111111111131
1300000000000000000440000000000000000001
1000000000000000000440000000000000000031
1311111111111700000000000071111111111101
1011111111111111110000111111111111111131
1313030303030303910000190000000000000101
1010111111111011310000101101111111110131
1313000000000081010000101700000000000101
1010000000000000310000100000000000000131
1313000000000001015006101000000000000101
1010000000000001311001101000000000000131
1303000000000001011301101000000000000301
1110000000000001311001101000000000000111
1110000000000001011001101000000000000111
0000003030303030311001100000000000000000
0000110111111111111001111111111113110000
0000113030303030303030303030303030113000
0000111111111111111111111111111111110000
