0000111111111111111111111111111111110000
0800110303030303030303030303030303010070
0000113111111111111001111111111111310000
0000030303030303011001130303030303000000
1110131313113111311001101110113131310111
1110111111130331011001131333311111110301
1030111111133111311001101110311111113131
1313131313110331011001131333113131310101
1010303030303111311001101110303030303131
1313131313131000016005130001313131310101
1010131313131061310000101501313131313131
1313111111111011010000131101111111110101
1010303030303030910000193030303030303131
1311111111111111110000111111111111111101
1011111111111800000000000081111111111131
1300000000000000000aa0000000000000000001
1000000000000000000aa0000000000000000031
1311111111111700000000000071111111111101
1011111111111111110000111111111111111131
1313030303030303910000190303030303030101
1010111111111011310000101101111111113131
1313131313131081010000131701313131310101
1010131313131000310000100001313131313131
1313030303030111015006131113030303030101
1010131313113331311001101330113131313131
1303111111130111011001131113311111110301
1110111111133331311001101330311111110111
1110131313110111011001131113113131310111
0000003030303030311001103030303030300000
0000110111111111111001111111111113110000
0500113030303030303030303030303030110060
0000111111111111111111111111111111110000
