1111111111111111111111111111111111111111
1000000000000000000000000000000000000001
1011111101111111110110111111111011111101
1011111101100000000110000000011011111101
1011000001101111111111111111011000001101
1011111101101111111111111111011111101101
1011000001100000000110000000011000001101
1011011111111111110110111111111111101101
1011011111111111110110111111111111101101
1011000001100000000000000000011000001101
1011111101101111111221111111011011111101
1011111101101222222222222221011011111101
1000000001101228225226227221011000000001
1011111101101222222222222221011011111101
1000000001101111111111111111011000000001
0011111100000000000110000000000011111100
0011111101101111110110111111011011111100
1000000001101111110110111111011000000001
1011111101101100000110000011011011111101
1000000001101101111111111011011000000001
1011111101101100000000000011011011111101
1011111101101101111111111011011011111101
1011000001101101111111111011011000001101
1011011111100000000000000000011111101101
1011011111101111111111111111011111101101
1011000001100000000110000000011000001101
1011111101111111110110111111111011111101
1011000001111111110110111111111000001101
1011111101100000000110000000011011111101
1011111101101111111111111111011011111101
1000000000000000000000000000000000000001
1111111111111111111111111111111111111111
