1111111111111111111001111111111111111111
1311030303030303030303030303030303031131
1311111011311111111111111111101131111131
1311111311030303030113030303031101111131
1311311011111111111111111111111131101131
1311011311111111111111111111111101131131
1311311030303030303110303030303031101131
1311011311011111111111111111131101131131
1311311011303030303030303030301131101131
1311030311011111111111111111131103031131
1311111011311111111111111111101131111131
1311111311030303030303030303031101111131
1311303011401111111221111111041130301131
1111111111111111111221111111111111111111
1111111111111822222222222251111111111111
3333333333331222222222222221333333333333
3333333333391222222222222221933333333333
1111111111111722222222222261111111111111
1111111111111111111221111111111111111111
1311000311401111111221111111041103031131
1311111011303030303030303030301131111131
1311111311011111111111111111131101111131
1311303011311111111111111111101130301131
1311011311030303030303030303031101131131
1311311011311111111111111111101131101131
1311011303030303030113030303030301131131
1311311011111111111111111111111131101131
1311011311111111111111111111111101131131
1311111011303030303110303030301131111131
1311111311011111111111111111131101111131
1311303030303030303030303030303030301131
1111111111111111111001111111111111111111
