1111111111111111111111111111111111111111
1111111111111111111111111111111111111111
1100000000000000000000000000000000000011
1100000000000000000000000000000000000011
1100110000000000000000000000000000110011
1100110000000000000000000000000000110011
1100000000000000000000000000000000000011
1100000000000000000000000000000000000011
1100110000000000000000000000000000110011
1100110000000000000000000000000000110011
1100110000000000000000000000000000110011
1100110000000000000000000000000000110011
1100110000000000000000000000000000110011
1100000011110011111001111100001100000011
1100000011110011111001111100001100000011
1100110011000011000000001100001100110011
1100110011000011000000001100001100110011
1100000011110011111111111100001100000011
1100000011110011111111111100001100000011
1100110000000000000000000000000000110011
1100110000000000000000000000000000110011
1100110000000000000000000000000000110011
1100110000000000000000000000000000110011
1100110000000000000000000000000000110011
1100000000000000000000000000000000000011
1100000000000000000000000000000000000011
1100110000000000000000000000000000110011
1100110000000000000000000000000000110011
1100000000000000000000000000000000000011
1100000000000000000000000000000000000011
1111111111111111111111111111111111111111
1111111111111111111111111111111111111111
