1111111111111111111111111111111111111111
1303030303030303030303030303030303030301
1011111131111111113110111111111011111131
1311111101130303030113030303011311111101
1011403031101111111111111111311030341131
1311111101131111111111111111011311111101
1011303031103030303110303030311030301131
1311011111111111110113111111111111131101
1011311111111111113110111111111111101131
1311030301130303030303030303011303031101
1011111131101111111221111111311011111131
1311111101131222222222222221011311111101
1030303031101228225226227221311030303031
1311111101131222222222222221011311111101
1030303031101111111111111111311030303031
0311111103030303030113030303030311111100
0011111131101111113110111111311011111130
1303030301131111110113111111011303030301
1011111131101130303110303011311011111131
1303030301131101111111111311011303030301
1011111131101130303030303011311011111131
1311111101131101111111111311011311111101
1011303031101131111111111011311030301131
1311011111130303030303030303011111131101
1011311111101111111111111111311111101131
1311030301130303030113030303011303031101
1011111131111111113110111111111011111131
1311430301111111110113111111111303091101
1011111131103030303110303030311011111131
1311111101131111111111111111011311111101
1030303030303030303030303030303030303031
1111111111111111111111111111111111111111
