1111111111111111111001111111111111111111
1403030303030303030303030303030303030341
1011111011311111111111111111101131111131
1311111311030303030113030303031101111101
1011303011111111113110111111111130301131
1311011311111111110113111111111101131101
1011311011303030303030303030301131101131
1311011311011111111111111111131101131101
1011311011311111111111111111101131101131
1303030303030303030113030303030003030001
1011111011311111111111111111101131111131
1311111311030303030113030303031101111101
1030303011901111110110111111041130303031
1311111111111111110110111111111111111101
1011111111111822220110222251111111111131
0322222222271222220110222221622222222200
0022222222281222220110222221522222222230
1311111111111722220110222261111111111101
1011111111111111110110111111111111111131
1303030311401111110110111111091103030301
1011111011303030303110303030301131111131
1311111311011111111111111111131101111101
1000303030303030303110303030303030300031
1311011311011111111111111111131101131101
1011311011311111111111111111101131101131
1311011311030303030303030303031101131101
1011311011111111113110111111111131101131
1311030311111111110113111111111103031101
1011111011303030303110303030301131111131
1311111311011111111111111111131101111101
1430303030303030303030303030303030303041
1111111111111111111001111111111111111111
