1111111111111111111001111111111111111111
1403030303030303030303030303030303030341
1011111011311111111111111111101131111131
1311011311030303030113030303031101131101
1011311011111111111111111111111131101131
1311011311111111111111111111111101131101
1011311011303030303030303030301131101131
1311011311011111111111111111131101131101
1011311111311111111111111111101111101131
1303030303030303030113030303030303030001
1011111111311111111111111111101111111131
1311111111030303030113030303031111111101
1030303011901111113110111111041130303031
1311111111111111110113111111111111111101
1011111111111822223110222251111111111131
0322222222271222220113222221622222222200
0022222222281222223110222221522222222230
1311111111111722220113222261111111111101
1011111111111111113110111111111111111131
1303030311401111110113111111091103030301
1011111111303030303110303030301111111131
1311111111011111111111111111131111111101
1000303030303030303110303030303030300031
1311011111011111111111111111131111131101
1011311011311111111111111111101131101131
1311011311030303030303030303031101131101
1011311011111111111111111111111131101131
1311011311111111111111111111111101131101
1011311011303030303110303030301131101131
1311111311011111111111111111131101111101
1430303030303030303030303030303030303041
1111111111111111111001111111111111111111
